m m m o o o o b o o
m m o o o b o o o o
m o o o o o o o b o
o o o b m o x x x x
o o o o m o o o o o
o b o o o o o o o o
o o o b m o o o o o
o o o m m o o o l o
o o o o o o o l o o
o o o o o o l o o o